この郡の地主	フョードル
アレクセイの父	フョードル
イワンの父	フョードル
ドミトリイの父は	フョードル
十三年前に悲劇的な陰惨な最後を遂げた	フョードル
彼は一生涯ほとんど自分の持ち村で暮らしたことがなかった	フョードル
一風変わった型の人間であった	フョードル
やくざで放埒ほうらつなばかりではなく	フョードル
自分の財産に関する細々した事務を、巧みに処理する	フョードル
それだけが身上かと思われるようなたぐいの人間	フョードル
ほとんど無一物で世間へ出て	フョードル
よその家へ行って食事をしたり、居候に転がりこむ	フョードル
死んだ時には現金で十万ルーブルものこしていた	フョードル
一生涯を、郡内きっての最もわからずやの狂気じみた男の一人	フョードル
けっしてばかであったというわけではない	フョードル
こういう狂気じみた人間	フョードル
彼は結婚して、三人の子を挙あげた。	フョードル
相手がどんな女であろうとも、すぐにしつこくつきまとう	フョードル
二万五千ルーブルからの金をすっかり巻きあげてしまった。	フョードル
絶え間なしにあつかましいおねだりや哀願をしていた	フョードル
衆人の前で、はずかしめられた良人という滑稽こっけいな役割を演じたり	フョードル
いろんな潤色まで施して自分がこうむった凌辱を事こまかに描き出して見せる	フョードル
道化者の面目を一新して、人の前へ出るのを嬉しがって	フョードル
自分の滑稽な立場に気がつかないようなふりをする	フョードル
放蕩もし、酒も飲み、乱暴もした	フョードル
自分の資本の運用はけっしておろそかにはしなかった。	フョードル
ヘルツェンシュトゥベという、この町の医者を呼んだ	フョードル
三千ルーブルのお金を入れた大きな封筒が用意してある	フョードル
前菜オードブルとコニャクを出させた。	フョードル
長男は先妻の腹から生まれた。	ドミトリイ
若干の財産を持っている	ドミトリイ
丁年に達したら独立することができるという確信をもっていた	ドミトリイ
中学校も中途でよして、ある陸軍の学校へはいり	ドミトリイ
コーカサスへ行って任官した	ドミトリイ
決闘をやったために位を貶おとされた	ドミトリイ
フョードルから仕送りを受けるようになった	ドミトリイ
かなりの借金をしていた	ドミトリイ
軽はずみで乱暴で、愛欲の強い、気短かな放蕩者	ドミトリイ
父親との交渉をかたづけるためにこの町へやって来た	ドミトリイ
まる一年グリゴリイのもとで下男小屋に暮らさなければならなかった。	ドミトリイ
又叔父おじのところに引き取られた	ドミトリイ
四度目に自分の巣を変えた	ドミトリイ
二十八であった	ドミトリイ
妙にかん走ったわめき声を立てるなり、グリゴリイに飛びかかって行った。	ドミトリイ
彼は裏口に錠のおりているのを見て取ったのだ。	ドミトリイ
老人の両の鬢に残っているまばらな髪をひっつかんだ。	ドミトリイ
老人を激しい地響きを立てて床に投げとばした。	ドミトリイ
父を激しい地響きを立てて床に投げとばした。	ドミトリイ
倒れた父の顔を靴の踵かかとで蹴けとばした	ドミトリイ
自分を不正直者と決めてしまった	ドミトリイ
絶望のあまり堕落の淵ふちへ飛びこむ	ドミトリイ
突発した事件を、カテリーナに伝えてくれと言いつけている	ドミトリイ
自分の胸をとんと拳こぶしでたたいた。	ドミトリイ
胸の上のポケットの中へでも蔵しまっておく	ドミトリイ
何かに縫いこんで首にぶら下げている	ドミトリイ
おれは悪党だ、折り紙つきの悪党だ	ドミトリイ
このおれの胸の中におれが持っている破廉恥	ドミトリイ
おれは中止しないで、決行するに違いない	ドミトリイ
自分はかえってイワンの競争を喜んでいる	ドミトリイ
熱しやすい性質にまかせて、非常に間違った、不体裁きわまることをしでかした	ドミトリイ
二等大尉に腹を立てて、大ぜいのいる前で相手の髯ひげを引っつかんだ	ドミトリイ
二等大尉を往来へ引きずり出した	ドミトリイ
長いこと往来を引き回した	ドミトリイ
湖水通りから遠くない横町に暮らしていた。	ドミトリイ
自分のしたことを後悔している	ドミトリイ
鬚を引っぱった	ドミトリイ
許嫁の妻をもはずかしめた	ドミトリイ
この集まりの主要人物は姿を見せなかった	ドミトリイ
もう一つ白状したいことがあるんだ	ドミトリイ
おれを見ろ、じっとおれを見るんだ	ドミトリイ
この郡の地主フョードルの三男	アレクセイ
彼はその時まだやっと満二十歳であった	アレクセイ
けっして狂信者ではない	アレクセイ
母の面影やその慈愛を覚えていた	アレクセイ
彼はある夏の静かな夕暮を覚えていた。	アレクセイ
その刹那の母の顔まで覚えていた。	アレクセイ
どこへ行っても人に好かれた。	アレクセイ
彼は侮辱を覚えていたことなどは一度としてなかった。	アレクセイ
相手を信じきったような、晴れ晴れした顔をしている。	アレクセイ
女に関するある種のことばやある種の会話を、はたで聞いていることすらできなかった。	アレクセイ
多額の金がはいったところで、最初に出会った無心者に施してしまう	アレクセイ
多額の金を慈善事業に寄付をする	アレクセイ
多額の金を巧妙な詐欺師にひっかかって巻きあげられる	アレクセイ
彼は中学の全課程を終えなかった。	アレクセイ
母の墓を見つけて、自分は修道院へはいりたいと言った	アレクセイ
修道僧たちも自分が新発意しんぼちになることを許してくれた	アレクセイ
リーズの椅子のかたわらで自分を待っていた旅の僧と問答を始めた	アレクセイ
僕冗談に言っただけなんだ、勘忍してくれたまえ。	アレクセイ
僕にだって名誉心があるからね	アレクセイ
修道院を迂回すると松林を抜けて、まっすぐに庵室へたどりついた	アレクセイ
出て行く前に、リーズの部屋の戸をあけようとした。	アレクセイ
僕はあの例の事件のことでまいったのです	アレクセイ
後妻の腹から生まれた。	アレクセイ
あの御手紙がまじめだってことはよく知っていたのですよ	アレクセイ
僕のしたこと、ひどくばかげたことだったかもしれませんね	アレクセイ
僕たちがあの不仕合わせな人の心をあんな風に解剖するのは	アレクセイ
あなたに手紙を渡すまいと思って嘘をついたんです	アレクセイ
僕は二、三日のうちに断然お寺を出ます。	アレクセイ
いったん世間へ出た以上、結婚しなくちゃなりません	アレクセイ
あなた以上の妻を娶めとることはできない。	アレクセイ
末の子	アレクセイ
未来の主人公	アレクセイ
修道院に住みこんでからすでに一年近くになる	アレクセイ
一生涯、人を信じきって暮らした	アレクセイ
相手を信じきったような、晴れ晴れした顔をしている	アレクセイ